11111
100C1
10E01
1P001
11111
