1111111111111
100100X0000C1
1000011111001
1P0011E000001
1000000111001
1000011111001
1000011111001
1000011111001
1000011111001
1000011111001
1000011111001
1000011111001
1000011111001
1000011111001
1111111111111